+-+-+-+-+-+-+-+-+-+-+-+-+-+-+-+-+
|S          |                   |
+-+-+-+ +-+-+ + + + + + + + + + +
|   |       |                   |
+ + + +-+-+ + + + + + + + + + + +
| | |   |   |                   |
+ + +-+ + +-+ + + + + + + + + + +
| |    G|   |                   |
+-+-+-+-+-+-+ + + + + + + + + + +
|                               |
+ + + + + + + + + + + + + + + + +
|                               |
+ + + + + + + + + + + + + + + + +
|                               |
+ + + + + + + + + + + + + + + + +
|                               |
+ + + + + + + + + + + + + + + + +
|                               |
+ + + + + + + + + + + + + + + + +
|                               |
+ + + + + + + + + + + + + + + + +
|                               |
+ + + + + + + + + + + + + + + + +
|                               |
+ + + + + + + + + + + + + + + + +
|                               |
+ + + + + + + + + + + + + + + + +
|                               |
+ + + + + + + + + + + + + + + + +
|                               |
+ + + + + + + + + + + + + + + + +
|                               |
+-+-+-+-+-+-+-+-+-+-+-+-+-+-+-+-+