+-+-+-+-+-+-+-+-+-+-+-+-+-+-+-+-+
|S          |                   |
+-+-+-+ +-+-+ + + + + + + + + + +
|           |                   |
+ + +-+-+-+-+ + + + + + + + + + +
| | |   |   |                   |
+ + +-+ + +-+-+-+ + + + + + + + +
| | |  G    |   |               |
+-+ +-+-+ +-+ +-+-+ + + + + + + +
|   |   | |       |             |
+ +-+-+ + + +-+-+ + + + + + + + +
|       |   | | | |             |
+-+ +-+ +-+ + + + + + + + + + + +
|       |     |   |             |
+-+ +-+ +-+ +-+ +-+ + + + + + + +
|       |     | |               |
+-+ +-+ +-+-+ + + + + + + + + + +
|               |               |
+-+-+-+-+-+-+-+-+ + + + + + + + +
|                               |
+ + + + + + + + + + + + + + + + +
|                               |
+ + + + + + + + + + + + + + + + +
|                               |
+ + + + + + + + + + + + + + + + +
|                               |
+ + + + + + + + + + + + + + + + +
|                               |
+ + + + + + + + + + + + + + + + +
|                               |
+ + + + + + + + + + + + + + + + +
|                               |
+-+-+-+-+-+-+-+-+-+-+-+-+-+-+-+-+